0 0 0 0 0 0 0 0 0 0 0 0 0 0 0
0 I 0 0 0 1 0 0 1 1 0 0 0 0 0
0 0 0 0 1 1 0 1 0 1 0 0 0 0 0
0 0 0 1 0 1 0 0 0 1 0 0 0 0 0
0 0 0 0 0 1 0 0 0 1 0 0 0 0 0
0 0 0 0 0 1 0 0 0 1 0 0 0 0 0
0 p X 0 0 1 0 0 0 1 0 0 0 0 0
0 0 0 0 0 0 0 0 0 0 0 0 0 0 0
0 0 0 0 0 0 0 0 0 0 0 0 0 0 0